x x x x x x x x x
x x x x x x x x x
x x x x x x x x x
x x x x x x x x x
x x x x x x x x x
x x x x x x x x x
x x x x x x x x x
x x x x x x x x x
x x x x x x x x x
x x x x x x x x x
x x x x x x x x x x x x x x x x x x
x x x x x x x x x p p x x x x x x x
x x x x x x x x x p p x x x x x x x
x x x x x x x x g90 s s g270 x x x x x
x x x x x x x x g90 s s g270 x x x x x
x x x x x x x x g90 s s g270 x x x x x
x x x x x x x x g90 s s g270 x x x x x
x x x x x x x x g90 s s g270 x x x x x
x x x x x x x x g90 s s g270 x x x x x
x x x x x x x x g90 s s g270 x x x x x